111111111111111111111111
100000000000000000000001
100000000000000000000001
100100000000000000000001
100100000000001000000001
100000000000000000000001
100100000000000000000001
100000000001000000000001
100000000000000000000001
100000000110000000000001
100000000110000000000001
100000000000000010000001
100000000000000000000001
100000000101000000000001
100000000101000000000001
100000000000000000000001
100000000000000000000001
111111111111111111111111